50
100
06 06 06 06 06 06 06 06 06 06 06 06 06 06 06 06 06 06 06 06 06 06 06 06 06 06 06 06 06 06 28 28 28 28 28 28 28 28 01 01 01 01 01 01 01 01 01 01 01 01 01 01 01 01 01 01 01 01 01 01 01 03 03 03 28 28 28 01 01 01 01 01 01 01 01 01 01 01 01 01 01 01 01 01 01 01 01 01 01 01 01 01 01 01 01 01 01 01 01 04
06 06 06 06 06 06 06 06 06 06 06 06 06 06 06 06 06 06 06 06 06 06 06 06 06 06 06 06 06 06 06 06 28 28 28 28 28 28 01 01 01 01 01 01 01 01 01 01 01 01 01 01 01 01 01 01 01 01 01 01 01 01 03 03 28 03 01 01 01 01 01 01 01 01 01 01 01 01 01 01 01 01 01 01 01 01 01 01 01 01 01 01 01 01 01 01 01 01 01 04
06 06 00 00 00 00 00 00 00 00 00 00 00 00 00 00 00 00 00 00 00 00 00 00 00 00 00 00 06 06 28 28 28 28 28 28 28 28 01 01 00 00 00 00 00 00 00 00 00 01 01 01 01 00 00 00 00 00 00 00 00 00 00 03 28 03 00 00 00 00 00 00 00 00 00 01 01 01 00 00 00 00 00 00 00 00 00 00 00 00 00 00 00 00 00 01 01 01 04 04
06 06 00 00 00 00 00 00 00 00 00 00 00 00 00 00 00 00 00 00 00 00 00 00 00 00 00 00 06 06 06 06 28 28 28 28 28 01 01 01 00 00 00 36 36 36 00 00 00 01 01 01 01 00 00 00 00 00 00 00 00 00 00 03 28 03 00 00 00 00 00 00 00 00 00 01 01 01 00 00 00 00 00 00 00 00 00 00 00 00 00 00 00 00 00 01 01 04 04 04
06 06 00 00 00 00 00 00 00 00 00 00 00 00 00 00 00 00 00 36 36 36 36 36 36 36 36 00 06 06 06 06 06 06 01 01 01 01 01 01 00 00 00 36 36 36 00 00 00 01 01 01 01 01 01 01 00 00 00 03 03 03 03 03 28 03 00 00 00 00 00 03 00 36 00 01 01 01 00 00 01 01 01 01 01 01 01 01 01 01 01 01 01 00 00 01 01 04 04 04
06 06 06 06 06 06 06 06 06 06 06 06 06 06 06 06 06 06 00 36 00 00 06 11 00 00 36 00 00 00 00 00 00 00 00 00 00 00 00 00 00 00 00 00 00 00 00 00 00 01 01 01 01 01 01 01 00 00 00 03 03 03 03 03 28 03 00 00 00 00 00 03 00 36 00 01 01 01 00 00 01 00 00 00 00 00 00 00 00 00 00 00 01 00 00 00 00 00 04 04
06 06 13 13 13 13 13 13 13 13 13 13 13 13 13 13 13 13 00 36 00 00 06 11 00 00 36 00 00 00 00 00 00 00 00 00 00 00 00 00 00 00 00 00 00 00 00 00 00 00 00 00 00 00 00 00 00 00 00 00 00 00 00 03 28 03 00 00 00 00 00 03 00 36 00 01 01 01 00 00 01 00 00 00 00 00 00 00 00 00 00 00 01 00 00 00 00 00 04 04
06 06 00 00 00 00 00 00 00 00 36 36 36 00 00 36 36 36 36 36 36 00 06 11 00 00 36 00 00 00 00 00 00 00 00 00 00 00 00 00 00 00 00 00 00 00 00 00 00 00 00 00 00 00 00 00 00 00 00 00 00 00 00 03 03 03 00 00 00 00 00 03 00 36 00 01 01 01 00 00 01 00 00 00 01 01 01 01 01 01 00 00 01 00 00 00 00 00 04 04
06 06 00 18 18 18 18 19 19 19 36 36 36 36 36 36 36 36 36 36 36 00 06 11 00 00 36 00 00 03 03 03 03 03 03 03 03 03 03 03 03 03 03 03 03 03 03 03 03 03 03 03 03 03 03 03 03 03 03 03 00 00 00 03 03 03 00 00 00 00 00 03 00 00 00 01 01 01 00 00 01 00 00 00 00 00 00 00 00 01 00 00 01 00 00 00 00 00 04 04
06 06 00 00 25 26 36 36 36 36 36 36 36 17 17 36 36 36 36 36 36 00 06 11 00 00 36 00 00 03 03 03 03 03 03 03 03 03 03 03 03 03 03 03 03 03 03 03 03 03 03 03 03 03 03 03 03 03 03 03 00 00 00 00 00 00 00 00 00 00 00 03 00 00 00 01 01 01 00 00 01 01 01 01 01 01 01 01 01 01 00 00 01 00 00 00 00 00 04 04
06 06 36 36 36 36 36 00 29 00 36 36 36 17 17 36 36 14 36 36 36 00 06 11 00 00 36 00 00 00 00 00 00 00 00 00 00 00 00 00 00 00 00 00 00 00 00 00 00 00 00 00 00 00 00 00 00 00 00 00 00 00 00 00 00 00 00 00 00 00 00 03 00 00 00 01 01 01 00 00 00 00 00 00 00 00 00 00 00 00 00 00 01 00 00 00 00 00 04 04
06 06 21 22 21 22 36 30 31 32 36 00 27 27 27 36 36 14 36 36 36 00 06 11 00 36 36 00 00 00 00 00 00 00 00 00 00 00 00 00 00 00 00 00 00 00 00 00 00 00 00 00 00 00 00 00 00 00 00 00 00 00 00 00 00 00 00 00 00 00 00 03 00 00 00 01 01 01 00 00 00 00 00 00 00 00 00 00 00 00 00 00 01 00 00 00 00 00 04 04
06 06 23 24 23 24 36 33 34 35 36 36 20 20 20 36 36 14 36 36 00 00 06 11 00 36 00 00 00 00 00 00 00 00 00 00 00 00 00 00 00 00 00 00 00 00 00 00 00 00 00 00 00 00 00 00 36 36 36 36 36 36 36 03 03 03 03 03 03 03 03 03 00 00 00 01 01 01 01 01 01 01 01 01 01 01 01 01 01 01 01 01 01 00 00 00 00 00 04 04
06 06 36 36 36 36 36 36 36 36 36 36 00 00 00 36 36 14 36 36 00 00 06 11 00 36 00 00 00 00 00 00 00 00 00 00 02 02 02 02 02 02 02 02 02 02 02 02 02 00 00 00 00 00 00 00 36 00 00 00 36 00 00 11 11 12 11 11 12 12 11 11 00 00 00 00 00 00 00 00 00 00 00 00 00 00 00 00 00 00 00 00 00 00 00 00 00 00 04 04
28 28 00 00 00 00 00 00 16 16 16 16 16 16 00 36 36 14 36 36 00 00 06 11 00 36 00 00 00 00 00 00 00 00 00 00 02 02 02 02 02 02 02 02 02 02 02 02 02 00 00 00 00 00 00 00 36 00 00 00 36 00 00 11 11 11 11 11 12 12 12 12 00 00 00 00 00 00 00 00 00 00 00 00 00 00 00 00 00 00 00 00 00 00 00 00 00 00 04 04
28 28 00 00 00 15 15 00 16 16 16 16 16 16 00 36 36 14 36 36 00 00 06 11 00 36 00 00 02 02 02 02 02 02 02 02 02 02 02 02 02 02 02 02 02 02 02 02 02 02 02 02 02 02 02 02 02 02 02 00 36 00 00 00 00 00 00 00 00 00 00 00 00 00 07 07 07 07 07 07 07 07 00 00 00 00 04 04 04 04 04 04 04 00 00 04 04 04 04 04
28 28 00 00 00 15 15 36 36 36 36 36 36 36 36 36 36 14 36 36 00 00 06 11 00 36 00 00 02 02 02 02 02 02 02 02 02 02 02 02 02 02 02 02 02 02 02 02 02 02 02 02 02 02 02 02 02 02 02 00 36 00 00 00 00 00 00 00 00 00 00 00 00 00 07 07 07 07 07 07 07 07 00 00 00 00 04 04 04 04 04 04 04 00 00 04 28 28 04 04
28 28 00 00 36 15 15 08 08 08 08 08 08 08 08 08 08 08 36 36 00 00 06 11 00 36 00 00 02 00 00 00 00 00 00 00 00 00 00 00 00 00 00 00 00 00 00 00 00 00 00 00 00 00 00 00 00 00 02 00 36 36 36 36 36 36 36 36 36 36 36 36 36 36 07 07 07 07 07 07 07 07 00 00 00 00 00 00 00 00 00 00 00 00 00 04 28 28 04 04
07 07 00 00 36 15 15 08 08 08 08 08 08 08 08 08 08 08 36 36 00 00 06 11 00 36 36 00 02 00 00 00 00 00 00 00 00 00 36 36 36 36 00 00 00 36 36 36 36 00 00 00 00 00 00 00 00 00 02 00 36 00 16 16 00 00 00 00 00 15 15 15 00 36 07 07 07 07 07 07 07 07 00 00 00 00 36 36 00 00 00 00 00 00 00 04 28 28 04 04
07 07 00 00 36 15 15 08 08 08 08 08 08 08 08 08 08 08 00 36 00 00 00 00 00 00 36 00 02 00 00 00 00 00 00 00 00 00 36 36 00 00 28 28 28 00 00 36 36 00 00 00 00 00 00 00 00 00 02 00 36 00 16 16 00 00 00 00 00 15 15 15 00 36 00 00 00 00 00 00 00 00 00 00 00 00 36 36 00 00 00 00 00 00 00 04 28 28 04 04
07 07 00 00 36 36 36 36 36 00 00 08 08 28 28 08 08 14 00 36 00 00 00 00 00 00 36 00 02 00 00 28 28 28 28 28 00 00 36 36 00 00 28 28 28 00 00 36 36 00 00 28 28 28 28 28 00 00 02 00 36 00 00 00 00 16 16 00 00 15 15 15 00 36 00 00 00 00 00 00 00 00 00 00 00 00 36 36 00 00 00 00 00 00 00 04 28 28 04 04
07 07 00 00 00 00 00 00 36 00 00 10 10 28 28 08 10 00 00 36 00 02 02 02 02 00 36 00 02 00 00 28 28 28 28 28 00 00 36 36 00 00 28 28 28 00 00 36 36 00 00 28 28 28 28 28 00 00 02 00 36 00 00 00 00 16 16 00 00 15 15 15 00 36 00 00 00 00 00 00 14 14 14 36 00 00 36 36 00 00 09 09 09 00 00 04 28 28 04 04
07 07 00 00 00 00 00 00 36 00 00 10 10 28 28 10 10 00 36 36 00 02 02 02 02 00 36 00 02 00 00 28 28 28 28 28 00 00 36 36 00 00 28 28 28 00 00 36 36 00 00 28 28 28 28 28 00 00 02 00 36 00 16 16 00 00 00 00 00 15 15 15 00 36 36 36 36 00 00 00 14 02 02 36 00 00 36 36 00 00 09 09 09 00 00 04 04 04 04 04
07 07 00 00 00 00 00 00 36 00 00 10 10 28 28 10 10 00 36 00 00 02 28 28 02 00 36 00 02 00 00 00 00 00 00 00 00 00 36 36 00 00 28 28 28 00 00 36 36 00 00 00 00 00 00 00 00 00 02 00 36 00 16 16 00 00 00 00 00 15 15 15 00 36 00 00 36 00 00 00 14 02 02 36 00 00 36 36 00 00 09 09 09 00 00 04 04 04 04 04
07 07 00 00 00 07 07 00 36 36 00 10 10 28 28 10 10 00 36 00 00 02 28 28 02 00 36 00 02 00 00 00 00 00 00 00 00 00 36 36 00 00 28 28 28 00 00 36 36 00 00 00 00 00 00 00 00 00 02 00 36 00 00 00 00 00 00 00 00 15 15 15 00 36 00 00 36 00 00 00 14 02 02 36 00 00 36 36 00 00 09 09 09 00 00 04 04 04 04 04
07 07 00 00 00 07 07 00 36 36 00 10 10 28 28 10 10 00 36 02 02 02 28 28 02 00 36 00 02 00 00 36 36 36 36 36 36 36 36 36 00 00 28 28 28 00 00 36 36 36 36 36 36 36 36 36 36 00 02 00 36 00 00 00 00 16 16 00 00 15 15 15 00 36 00 00 36 00 00 00 02 02 02 36 00 00 36 36 00 00 09 09 09 00 00 00 00 00 04 04
07 07 00 00 00 07 07 00 00 36 00 10 10 10 10 10 10 00 36 02 02 02 28 28 02 00 36 00 02 00 00 36 36 36 36 36 36 36 36 36 00 00 28 28 28 00 00 36 36 36 36 36 36 36 36 36 36 00 02 00 36 00 00 00 00 16 16 00 00 00 00 00 00 36 00 00 36 00 00 00 02 02 02 36 00 00 00 00 00 00 00 00 00 00 00 00 00 00 04 04
07 07 00 00 00 07 07 00 00 36 00 10 10 10 10 10 10 00 36 02 02 02 28 28 02 00 36 00 02 00 00 36 36 00 00 00 00 00 00 00 00 00 28 28 28 00 00 00 00 00 00 00 00 00 00 36 36 00 02 00 36 00 00 00 00 00 00 00 00 00 00 00 00 36 00 00 36 00 00 00 02 02 02 36 00 00 00 00 00 00 00 00 00 00 00 00 00 00 04 04
07 07 00 00 00 07 07 00 00 36 00 10 10 10 10 10 10 00 36 00 00 02 28 28 02 00 36 00 02 00 00 36 36 00 00 00 28 28 28 28 28 28 28 28 28 28 28 28 28 28 28 28 28 28 00 36 36 00 02 00 36 36 36 36 36 36 36 36 36 36 36 36 36 36 36 36 36 00 00 00 02 02 02 36 00 00 00 00 00 00 00 00 00 00 00 00 00 00 04 04
07 07 00 00 00 07 07 00 00 36 00 00 00 36 00 00 00 00 36 00 00 02 28 28 02 00 36 00 02 00 00 36 36 00 00 00 28 28 28 28 28 28 28 28 28 28 28 28 28 28 28 28 28 28 00 36 36 00 02 00 00 00 08 08 08 08 08 08 08 08 08 08 08 08 08 08 08 08 08 08 08 08 08 36 00 00 00 00 00 00 00 00 00 00 00 00 00 00 04 04
07 07 00 00 00 07 07 00 00 36 36 36 36 36 36 00 00 00 36 36 00 02 02 02 02 00 36 00 02 00 00 36 36 00 00 00 28 28 28 28 28 28 28 28 28 28 28 28 28 28 28 28 28 28 00 36 36 00 02 00 00 00 08 08 08 08 08 08 08 08 08 08 08 08 08 08 08 08 08 08 08 08 08 36 00 00 00 00 00 00 00 00 00 00 00 00 00 00 04 04
07 07 00 00 00 07 07 00 00 00 00 00 36 36 00 00 00 00 36 36 00 02 02 02 02 00 36 00 02 00 00 36 36 00 00 00 28 28 28 28 28 28 28 28 28 28 28 28 28 28 28 28 28 28 00 36 36 00 02 00 00 00 06 06 06 06 11 36 36 36 36 36 36 36 36 36 36 36 36 36 36 36 36 36 00 00 00 00 00 00 00 00 00 00 00 00 00 00 04 04
07 07 00 00 00 07 07 00 00 00 00 00 00 00 00 00 00 00 00 36 00 02 02 02 02 00 36 36 36 36 36 36 36 00 00 00 28 28 28 28 28 28 28 28 28 28 28 28 28 28 28 28 28 28 00 36 36 00 02 00 00 00 06 06 06 06 11 36 00 00 00 00 00 00 00 00 00 00 00 00 00 00 00 00 00 00 00 00 00 00 00 00 00 00 00 00 00 00 04 04
07 07 00 00 00 07 07 00 00 00 00 00 00 00 00 00 00 00 00 36 00 00 00 00 00 00 00 00 00 00 36 36 36 00 00 00 28 28 28 28 28 28 28 28 28 28 28 28 28 28 28 28 28 28 00 36 36 00 02 00 00 00 06 06 06 06 11 36 00 00 00 00 00 00 00 00 00 00 00 00 00 00 00 00 00 00 00 00 00 00 00 00 00 00 00 00 00 00 04 04
07 07 00 00 00 00 00 00 00 00 00 00 00 00 00 00 00 00 00 36 00 00 00 00 00 00 00 00 00 00 00 36 36 00 00 00 28 28 28 28 28 28 28 28 28 28 28 28 28 28 28 28 28 28 00 36 36 00 02 00 00 00 06 06 06 06 11 36 00 00 00 00 00 00 00 00 00 00 00 00 00 00 00 00 00 00 00 00 00 00 00 00 00 00 00 00 00 00 04 04
07 07 00 00 00 00 00 00 00 00 00 07 07 07 07 07 07 00 00 36 02 02 02 02 02 02 02 02 00 00 00 36 36 00 00 00 28 28 28 28 28 28 28 28 28 28 28 28 28 28 28 28 28 28 00 36 36 00 02 00 00 00 06 06 06 06 11 36 00 00 00 00 05 05 05 05 05 05 05 05 05 05 05 05 05 05 05 00 00 00 00 00 00 00 00 00 00 00 04 04
07 07 00 36 36 00 00 00 00 00 00 07 07 07 07 07 07 00 00 36 02 02 02 02 02 02 02 02 00 00 00 36 36 00 00 00 00 00 00 00 00 00 00 00 00 00 00 00 00 00 00 00 00 00 00 36 36 00 00 00 00 00 06 06 06 06 11 36 00 00 00 00 05 05 05 05 05 05 05 05 05 05 05 05 05 05 05 00 00 00 00 00 00 00 00 00 00 00 04 04
07 07 00 36 36 36 00 00 00 00 00 07 07 07 07 07 07 00 00 36 02 02 02 02 02 02 02 02 00 00 00 36 36 00 00 00 00 00 00 00 00 00 00 00 00 00 00 00 00 00 00 00 00 00 00 36 36 36 36 36 36 36 06 06 06 06 11 36 00 00 00 00 05 05 05 05 05 05 05 05 05 05 05 05 05 05 05 00 00 00 00 00 00 00 00 00 00 00 04 04
07 07 00 36 36 36 00 00 00 00 00 07 07 07 07 07 07 00 00 36 00 00 00 00 00 00 00 00 00 00 00 36 36 36 36 36 36 36 36 36 36 36 36 36 36 36 36 36 36 36 36 36 36 36 36 36 36 00 00 00 00 36 06 06 06 06 11 36 00 00 00 00 05 05 00 00 00 00 00 00 00 00 00 00 00 00 00 00 00 00 00 00 00 00 00 00 00 00 05 05
07 07 00 00 00 00 00 00 00 00 00 07 07 07 07 07 07 00 36 36 00 00 00 00 00 00 00 00 00 00 00 36 36 36 36 36 36 36 36 36 36 36 36 36 36 36 36 36 36 36 36 36 36 36 36 36 36 00 00 00 00 36 06 06 06 06 11 36 00 00 00 00 05 05 00 00 00 00 00 00 00 00 00 00 00 00 00 00 00 00 00 00 00 00 00 00 00 00 05 05
07 07 00 00 00 00 00 00 00 00 00 00 00 00 00 00 00 00 36 00 00 00 00 00 00 00 00 00 00 00 00 00 00 00 00 00 00 00 00 00 00 00 00 00 00 00 00 00 00 00 00 00 00 00 00 00 00 00 00 00 00 36 36 36 36 36 36 36 00 00 00 00 05 05 00 00 00 00 00 00 00 00 00 00 00 00 00 00 00 00 00 00 00 00 00 00 00 00 05 05
07 07 00 00 00 00 00 00 00 00 00 00 00 00 00 00 00 00 36 00 00 00 00 00 00 00 00 00 00 00 00 00 00 00 00 00 00 00 00 00 00 00 00 00 00 00 00 00 00 00 00 00 00 00 00 00 00 00 00 00 00 00 00 00 00 00 00 00 00 00 00 00 05 05 00 00 00 00 05 05 05 05 05 05 05 05 05 05 05 05 05 05 05 05 00 00 00 00 05 05
07 07 00 00 00 00 07 07 07 00 00 00 00 00 06 06 06 00 36 00 00 00 28 28 28 28 28 00 00 00 00 00 10 10 10 10 10 10 10 10 10 10 10 10 10 10 10 10 10 00 00 00 00 00 00 00 00 00 00 00 00 00 00 00 00 00 00 00 00 00 00 00 05 05 00 00 00 00 05 05 05 05 05 05 05 05 05 05 05 05 05 05 05 05 00 00 00 00 05 05
07 07 00 00 00 00 07 07 07 00 00 00 00 00 06 06 06 00 36 00 00 00 28 28 28 28 28 00 00 00 00 00 10 10 10 10 10 10 10 10 10 10 10 10 10 10 10 10 10 00 00 00 00 00 00 03 03 03 03 03 03 03 03 03 03 03 03 03 03 03 00 00 05 05 00 00 00 00 05 05 05 00 00 00 00 00 00 00 00 00 00 00 00 00 00 00 00 00 05 05
07 07 00 00 00 00 07 07 07 00 00 00 00 00 06 06 06 00 36 00 00 00 28 28 28 28 28 00 00 00 00 00 00 00 00 00 00 00 00 00 00 00 00 00 00 00 00 00 00 00 00 00 00 00 00 03 03 03 03 03 03 03 03 03 03 03 03 03 03 03 00 00 05 05 00 00 00 00 05 05 05 00 00 00 00 36 36 36 36 36 36 00 00 00 00 00 00 00 05 05
07 07 00 00 00 00 07 07 07 00 00 00 00 00 06 06 06 00 36 00 00 00 28 28 28 28 28 00 00 00 00 00 00 00 00 00 00 00 00 00 00 00 00 00 00 00 00 00 00 00 00 00 00 00 00 03 03 03 03 03 03 03 03 03 03 03 03 03 03 03 00 00 05 05 00 00 00 00 05 05 05 00 00 00 00 36 36 36 36 36 36 00 00 00 00 00 00 00 05 05
07 07 00 00 00 00 00 00 00 00 00 00 00 00 00 00 00 00 36 00 00 00 00 00 00 00 00 00 00 00 00 00 00 00 00 00 00 00 00 00 00 00 00 00 00 00 00 00 00 00 00 00 00 00 00 00 00 00 00 00 00 00 00 00 00 00 00 00 00 00 00 00 05 05 00 00 00 00 05 05 05 00 00 00 00 00 00 00 00 00 00 00 00 00 00 00 00 00 05 05
28 28 00 00 00 00 00 00 00 00 00 00 00 00 00 00 00 00 36 00 00 00 00 00 00 00 00 00 00 00 00 00 00 00 00 00 00 00 00 00 00 00 00 00 00 00 00 00 00 00 00 00 00 00 00 00 00 00 00 00 00 00 00 00 00 00 00 00 00 00 00 00 05 05 00 00 00 00 05 05 05 00 00 00 00 00 00 00 00 00 00 00 00 00 00 00 00 00 05 05
28 28 28 28 05 05 05 05 05 05 05 05 05 05 05 05 05 05 05 05 05 05 05 05 05 05 05 05 05 05 05 05 05 05 05 05 05 05 05 05 05 05 05 05 05 05 05 05 05 05 05 05 05 05 05 05 05 05 05 05 05 05 05 05 05 05 05 05 05 05 05 05 05 05 05 05 05 05 05 05 05 05 05 05 05 05 05 05 05 05 05 05 05 05 05 05 05 05 05 05 
28 28 28 28 28 28 05 05 05 05 05 05 05 05 05 05 05 05 05 05 05 05 05 05 05 05 05 05 05 05 05 05 05 05 05 05 05 05 05 05 05 05 05 05 05 05 05 05 05 05 05 05 05 05 05 05 05 05 05 05 05 05 05 05 05 05 05 05 05 05 05 05 05 05 05 05 05 05 05 05 05 05 05 05 05 05 05 05 05 05 05 05 05 05 05 05 05 05 05 05